MGLCD	KEYWORD1

initLCD	KEYWORD2
rotateDisplay	KEYWORD2
clrScr	KEYWORD2
fillScr	KEYWORD2
invert	KEYWORD2
setPixel	KEYWORD2
clrPixel	KEYWORD2
invPixel	KEYWORD2
drawLine	KEYWORD2
drawRect	KEYWORD2
drawRoundRect	KEYWORD2
drawCircle	KEYWORD2
drawBitmap	KEYWORD2
invertText	KEYWORD2
print	KEYWORD2
printNumI	KEYWORD2
printNumF	KEYWORD2
setFont	KEYWORD2

LEFT	LITERAL1
RIGHT	LITERAL1
CENTER	LITERAL1
